00000000000000000000000000000000000000000000000000000000000000000000000000000000000000000000
00000000000000000000000000000000000000000000000000000000000000000000000000000000000000000000
00000000000000000000000000000000000000000000000000000000000000000000000000000000000000000000
00000000000000000000000000000000000000000000000000000000000000000000000000000000000000000000
00000000222220000000000000000000000000000000000000000000000000000000000000000000000000000000
00000000000000000000000000000000000000000000000000000000000000000000000000000000000000000000
02200000000000000022000000022000000000000000000000000000000000000000000000000000000000000000
01122222222222222211000002211200000000000000000000000000000000000000000000000000000000000000
01111111111111111111022201111102222222222002220000000000000000022222222002222222222222222222
01111111111111111111001000110001111111110000100002220000000000211111110000111111111111111110
01111111111111111111000000100000111111100000000000112200000022110000000000000000000000000000
01111111111111111111000000100000010111000000000000011122222211100000000000000000000000000000
01111111111111111111000000000000000010000000000000001111111111000000000000000000000000000000