000000000000000000000000000000000000000000000000000000000000000000000000000000000000000000000000000000000000000000000000000000000000
000000000000000000000000000000000000000000000000000000000000000000000000000000000000000000000000000000000000000000000000000000000000
000000000000000000000000000000000000000000000000000000000000000000000000000000000000000000000000000000000000000000000000000000000000
000000000000000000000000000000000000000000000000000000000000000000000000000000000000000000000000000000000000000000000000000000000000
000000000000000000002222222200000000000000000000000000000000000000000000000000000000000000000000000000000000000000000000000000000000
000000002222200222221111111122222200000000000000000000000000000000000000000000000000000000000000000000000000000000000000000000000000
000000000111000011111111111111111000022222222000000000000000000000000000000000000000000000000000000000000000000000000000000000000000
000000000010000001111111111111110000001111111222222000000000000000000000022220022220000000000000000000000000022222000000000000000000
000000000000000000111111111111100000000111111111111222200000000000000020001100001100000000000000000000002222211110000222222222222200
000000000000000000011111111111000000000011111111111111000000000000000012000000000000022220022220002222221111111100000011111111111000
000000000000000000000000000000000000000000000000000000000000000000000011200000000000011100001100000111111111111000000000000000000000
000000000000000000000000000000000000000000000000000000000222222222222211122000000000011000000000000011111111110000000000000000000000
000000000000000000000000000000000000000000000000000000000011111111111111111200000000210000000000000001111111100000000000000000000000
000000000000000000000000000000000000000000000000222222200000000000000000000000222222100000000000000000000000000000000000000000000000
000000000000000000000000000000000000000000000000011111000000000000000000000002111111000000000000000000000000000000000000000000000000
000000000000000000000000000000000000000000000000000000000000000000000000000021111110000000000000000000000000000000000000000000000000
000000000000000000000000000000000000000000000000000000000222222222222222222211111000000000000000000000000000000000000000000000000000
000000000000000000000000000000000000000000000000000000000011111111111111111111110000000000000000000000000000000000000000000000000000
000000000000000000000000000000000000000000000000000000000000000000000000000000000000000000000000000000000000000000000000000000000000