000000000000000000000000000000000000000000000000000000000000000000000000000000000000000000000000000000
000000000000000000000000000000000000000000000000000000000000000000000000000000000000000000000000000000
000000000000000000000000000000000000000000000000000000000000000000000000000000000000000000000000000000
000000000000000000000000000000000000000000000000000000000000000000000000000000000000000000000000000000
000000000000022222000000000000000000000000000000000000000000000000000000000000000000000000000000000000
000000000000000000000000000000000000000000000000000000000000000000000000000000000000000000000000000000
000000220000000000000002200000002200000000000000000000000000000000000000000000000000000000000000000000
000000112222222222222221100000221120000000000000000000000000000000000000000000000000000000000000000000
000000111111111111111111102220111110222222222200222000000000000000002222222200222222222222222222200000
000000111111111111111111100100011000111111111000010000222000000000021111111000011111111111111111000000
000000111111111111111111100000010000011111110000000000011220000002211000000000000000000000000000000000
000000111111111111111111100000010000001111100000000000001112222221110000000000000000000000000000000000
000000111111111111111111100000000000000111000000000000000111111111100000000000000000000000000000000000
000000000000000000000000000000000000000010000000000000000011111111000000000000000000000000000000000000
000000000000000000000000000000000000000000000000000000000000000000000000000000000000000000000000000000
------------------------------------------------------------------------------------------------------